NO ./include/assets/textures/eagle.xpm
SO ./include/assets/textures/greystone.xpm
WE ./include/assets/textures/red.xpm
EA ./include/assets/textures/purplestone.xpm

C 53,41,34
F 205,33,27

111111111111111
111111000111111
111110000011111
1111000N0001111
111000000000111
1100000000000011
10000111110010001
110000111001 1101
11100001001   101
111100000001 1001
1111100000001101
1111110001100001
111111111111111

