111111111111111
10000100D000001
1C0D01000011101
1110010C1000101
100C0000000E0P1
111111111111111
